1111111111111111111111111
1000000001000000000100001
100000000100000000000E001
100P0000000000C0000111111
1000000001000000000000001
1000000001000000000C00001
1000000C01000C00000000001
1111111111111111111111111
